0, 0, 0, 253, 254, 0, 0, 0, 0, 0, 0, 0, 0, 0, 0, 0, 
0, 0, 0, 88,
0, 0, 0, 0, 0, 0, 0, 0, 0, 0, 0, 0, 0, 0, 0, 0, 
0, 0, 0, 84,
0, 0, 0, 0, 0, 0, 0, 0, 0, 0, 0, 0, 0, 0, 84, 84, 
0, 0, 0, 0,
0, 0, 0, 0, 0, 0, 0, 0, 0, 0, 84, 84, 0, 0, 0, 0, 
0, 0, 0, 0,
0, 0, 0, 0, 0, 0, 0, 0, 0, 0, 0, 0, 0, 0, 0, 0, 
0, 0, 0, 0,
0, 0, 0, 0, 0, 0, 0, 84, 0, 0, 0, 0, 0, 0, 0, 0, 
0, 0, 0, 0,
0, 0, 0, 0, 0, 0, 84, 84, 0, 0, 0, 0, 0, 0, 0, 0, 
0, 0, 0, 0,
0, 0, 0, 0, 0, 84, 84, 84, 0, 0, 0, 0, 0, 0, 0, 0, 
0, 0, 0, 0,
0, 0, 0, 0, 84, 84, 84, 84, 0, 0, 0, 0, 0, 0, 84, 84, 
84, 0, 0, 0,
0, 0, 0, 84, 84, 84, 84, 84, 0, 0, 0, 0, 0, 0, 0, 0, 
0, 0, 0, 0